//MAP CONVERTED BY dmm2tgm.py THIS HEADER COMMENT PREVENTS RECONVERSION, DO NOT REMOVE
"a" = (
/turf/closed/wall/mineral/titanium/spaceship/nodiagonal,
/area/shuttle/ds2dropship)
"d" = (
/turf/template_noop,
/area/template_noop)
"e" = (
/obj/effect/turf_decal/siding/thinplating_new/dark{
	dir = 10
	},
/obj/structure/closet/secure_closet{
	req_access = list("syndicate");
	name = "armor stow"
	},
/obj/effect/turf_decal/trimline/dark_red/corner{
	dir = 4
	},
/turf/open/floor/mineral/plastitanium,
/area/shuttle/ds2dropship)
"f" = (
/obj/effect/turf_decal/siding/thinplating_new/dark{
	dir = 4
	},
/obj/structure/table/reinforced/plastitaniumglass,
/obj/effect/turf_decal/trimline/dark_red/warning{
	dir = 8
	},
/obj/item/toy/figure/syndie{
	pixel_x = 8;
	pixel_y = 15
	},
/obj/item/paper_bin{
	pixel_y = 5
	},
/obj/item/pen,
/turf/open/floor/mineral/plastitanium,
/area/shuttle/ds2dropship)
"g" = (
/obj/machinery/door/airlock/hatch,
/obj/effect/mapping_helpers/airlock/access/all/syndicate/general,
/obj/effect/mapping_helpers/airlock/cutaiwire,
/obj/docking_port/mobile{
	dir = 4;
	shuttle_id = "dsdrop_alpha";
	name = "Alpha Dropship"
	},
/obj/effect/mapping_helpers/airlock/unres{
	dir = 4
	},
/turf/open/floor/plating,
/area/shuttle/ds2dropship)
"h" = (
/obj/structure/chair/comfy/shuttle/tactical{
	dir = 4
	},
/obj/structure/window/reinforced/survival_pod/spawner/west,
/obj/effect/turf_decal/trimline/dark_red/warning,
/turf/open/floor/iron/dark/small,
/area/shuttle/ds2dropship)
"j" = (
/obj/machinery/power/shuttle_engine/propulsion/left,
/turf/open/floor/plating,
/area/shuttle/ds2dropship)
"k" = (
/obj/machinery/door/airlock/hatch,
/obj/effect/mapping_helpers/airlock/access/all/syndicate/general,
/obj/effect/mapping_helpers/airlock/cutaiwire,
/obj/effect/mapping_helpers/airlock/unres{
	dir = 8
	},
/turf/open/floor/plating,
/area/shuttle/ds2dropship)
"l" = (
/turf/open/floor/catwalk_floor/iron_dark,
/area/shuttle/ds2dropship)
"n" = (
/turf/closed/wall/mineral/titanium/spaceship,
/area/shuttle/ds2dropship)
"u" = (
/obj/machinery/power/shuttle_engine/heater,
/obj/structure/window/reinforced/survival_pod/spawner/north,
/obj/structure/window/reinforced/survival_pod/spawner{
	dir = 5
	},
/turf/open/floor/plating,
/area/shuttle/ds2dropship)
"v" = (
/obj/machinery/computer/camera_advanced/shuttle_docker/ds2dropship,
/obj/effect/turf_decal/siding/thinplating_new/dark,
/obj/effect/turf_decal/trimline/dark_red/warning{
	dir = 1
	},
/turf/open/floor/mineral/plastitanium,
/area/shuttle/ds2dropship)
"w" = (
/obj/structure/window/reinforced/shuttle/spaceship,
/obj/structure/grille,
/turf/open/floor/plating,
/area/shuttle/ds2dropship)
"B" = (
/obj/structure/chair/comfy/shuttle/tactical{
	dir = 8
	},
/obj/structure/window/reinforced/survival_pod/spawner/east,
/obj/structure/window/reinforced/survival_pod/spawner{
	dir = 5
	},
/obj/effect/turf_decal/siding/dark{
	dir = 1
	},
/turf/open/floor/iron/dark/small,
/area/shuttle/ds2dropship)
"H" = (
/obj/structure/chair/comfy/shuttle/tactical{
	dir = 4
	},
/obj/effect/turf_decal/siding/dark{
	dir = 1
	},
/obj/machinery/light/directional/west,
/turf/open/floor/iron/dark/small,
/area/shuttle/ds2dropship)
"I" = (
/obj/structure/chair/comfy/shuttle/tactical{
	dir = 8
	},
/obj/effect/turf_decal/trimline/dark_red/warning,
/turf/open/floor/iron/dark/small,
/area/shuttle/ds2dropship)
"J" = (
/obj/structure/chair/comfy/shuttle/tactical{
	dir = 8
	},
/obj/effect/turf_decal/siding/dark{
	dir = 1
	},
/obj/machinery/light/directional/east,
/turf/open/floor/iron/dark/small,
/area/shuttle/ds2dropship)
"K" = (
/obj/structure/chair/comfy/shuttle/tactical{
	dir = 4
	},
/obj/structure/window/reinforced/survival_pod/spawner/west,
/obj/structure/window/reinforced/survival_pod/spawner{
	dir = 9
	},
/obj/effect/turf_decal/siding/dark{
	dir = 1
	},
/turf/open/floor/iron/dark/small,
/area/shuttle/ds2dropship)
"L" = (
/obj/machinery/computer/shuttle/ds2dropship,
/obj/effect/turf_decal/siding/thinplating_new/dark,
/obj/effect/turf_decal/trimline/dark_red/warning{
	dir = 1
	},
/turf/open/floor/mineral/plastitanium,
/area/shuttle/ds2dropship)
"N" = (
/obj/effect/turf_decal/siding/thinplating_new/dark{
	dir = 6
	},
/obj/structure/table/reinforced/plastitaniumglass,
/obj/effect/turf_decal/trimline/dark_red/corner{
	dir = 1
	},
/turf/open/floor/mineral/plastitanium,
/area/shuttle/ds2dropship)
"O" = (
/obj/machinery/power/shuttle_engine/propulsion/right,
/turf/open/floor/plating,
/area/shuttle/ds2dropship)
"Q" = (
/obj/structure/chair/comfy/shuttle/tactical{
	dir = 8
	},
/obj/structure/window/reinforced/survival_pod/spawner/east,
/obj/effect/turf_decal/trimline/dark_red/warning,
/turf/open/floor/iron/dark/small,
/area/shuttle/ds2dropship)
"R" = (
/obj/structure/chair/comfy/shuttle/tactical{
	dir = 4
	},
/obj/effect/turf_decal/trimline/dark_red/warning,
/turf/open/floor/iron/dark/small,
/area/shuttle/ds2dropship)
"S" = (
/turf/open/floor/iron/dark/smooth_corner{
	dir = 8
	},
/area/shuttle/ds2dropship)
"T" = (
/obj/structure/chair/office/tactical{
	dir = 1
	},
/turf/open/floor/iron/dark/smooth_corner,
/area/shuttle/ds2dropship)
"U" = (
/turf/open/floor/iron/dark/smooth_half,
/area/shuttle/ds2dropship)
"X" = (
/obj/machinery/power/shuttle_engine/heater,
/obj/structure/window/reinforced/survival_pod/spawner/north,
/obj/structure/window/reinforced/survival_pod/spawner{
	dir = 9
	},
/turf/open/floor/plating,
/area/shuttle/ds2dropship)
"Z" = (
/obj/effect/turf_decal/siding/thinplating_new/dark{
	dir = 8
	},
/obj/structure/closet/secure_closet{
	req_access = list("syndicate");
	name = "weapon stow"
	},
/obj/effect/turf_decal/trimline/dark_red/warning{
	dir = 4
	},
/turf/open/floor/mineral/plastitanium,
/area/shuttle/ds2dropship)

(1,1,1) = {"
d
n
w
a
g
a
w
n
d
"}
(2,1,1) = {"
a
a
f
N
l
H
R
a
a
"}
(3,1,1) = {"
w
v
T
U
l
B
Q
u
j
"}
(4,1,1) = {"
w
L
S
U
l
K
h
X
O
"}
(5,1,1) = {"
a
a
Z
e
l
J
I
a
a
"}
(6,1,1) = {"
d
n
w
a
k
a
w
n
d
"}
